/	mainapp.views.main	main
/__debug__/history_refresh/	debug_toolbar.panels.history.views.history_refresh	djdt:history_refresh
/__debug__/history_sidebar/	debug_toolbar.panels.history.views.history_sidebar	djdt:history_sidebar
/__debug__/render_panel/	debug_toolbar.views.render_panel	djdt:render_panel
/__debug__/sql_explain/	debug_toolbar.panels.sql.views.sql_explain	djdt:sql_explain
/__debug__/sql_profile/	debug_toolbar.panels.sql.views.sql_profile	djdt:sql_profile
/__debug__/sql_select/	debug_toolbar.panels.sql.views.sql_select	djdt:sql_select
/__debug__/template_source/	debug_toolbar.panels.templates.views.template_source	djdt:template_source
/admin/adminapp:user_order_status_change/<str:status>/<int:pk>/	adminapp.views.user_order_status_change	admin:user_order_status_change
/admin/categories/create/	adminapp.views.ProductCategoryCreateView	admin:category_create
/admin/categories/delete/<int:pk>	adminapp.views.ProductCategoryDeleteView	admin:category_delete
/admin/categories/read/	adminapp.views.ProductCategoriesListView	admin:category_read
/admin/categories/update/<int:pk>/	adminapp.views.ProductCategoryUpdateView	admin:category_update
/admin/products/create/<int:pk>	adminapp.views.ProductCreateView	admin:product_create
/admin/products/delete/<int:pk>/	adminapp.views.ProductDeleteView	admin:product_delete
/admin/products/read/<int:pk>	adminapp.views.ProductDetailView	admin:product_read
/admin/products/read/category/<int:pk>/	adminapp.views.ProductListView	admin:products
/admin/products/update/<int:pk>/	adminapp.views.ProductUpdateView	admin:product_update
/admin/user_order_update/<int:pk>/	adminapp.views.user_order_update	admin:user_order_update
/admin/users/create/	adminapp.views.UserCreateView	admin:user_create
/admin/users/delete/<int:pk>	adminapp.views.UserDeleteView	admin:user_delete
/admin/users/read/	adminapp.views.UserListView	admin:user_read
/admin/users/update/<int:pk>/	adminapp.views.UserUpdateView	admin:user_update
/auth/edit/	authapp.views.edit	auth:edit
/auth/login/	authapp.views.login	auth:login
/auth/logout/	authapp.views.logout	auth:logout
/auth/not_success/	authapp.views.not_success	auth:not_success
/auth/register/	authapp.views.register	auth:register
/auth/success/	authapp.views.success	auth:success
/auth/verify/<email>/<activation_key>/	authapp.views.verify	auth:verify
/basket/	basketapp.views.BasketListView	basket:view
/basket/add/<int:pk>/	basketapp.views.BasketAddView	basket:add
/basket/edit/<int:pk>/<int:quantity>/	basketapp.views.BasketUpdateView	basket:edit
/basket/remove/<int:pk>/	basketapp.views.BasketDeleteView	basket:remove
/complete/<backend>/	social_django.views.complete	cosial:complete
/contact/	mainapp.views.contact	contact
/control/	django.contrib.admin.sites.index	admin:index
/control/<app_label>/	django.contrib.admin.sites.app_index	admin:app_list
/control/auth/group/	django.contrib.admin.options.changelist_view	admin:auth_group_changelist
/control/auth/group/<path:object_id>/	django.views.generic.base.RedirectView
/control/auth/group/<path:object_id>/change/	django.contrib.admin.options.change_view	admin:auth_group_change
/control/auth/group/<path:object_id>/delete/	django.contrib.admin.options.delete_view	admin:auth_group_delete
/control/auth/group/<path:object_id>/history/	django.contrib.admin.options.history_view	admin:auth_group_history
/control/auth/group/add/	django.contrib.admin.options.add_view	admin:auth_group_add
/control/auth/group/autocomplete/	django.contrib.admin.options.autocomplete_view	admin:auth_group_autocomplete
/control/authapp/shopuser/	django.contrib.admin.options.changelist_view	admin:authapp_shopuser_changelist
/control/authapp/shopuser/<path:object_id>/	django.views.generic.base.RedirectView
/control/authapp/shopuser/<path:object_id>/change/	django.contrib.admin.options.change_view	admin:authapp_shopuser_change
/control/authapp/shopuser/<path:object_id>/delete/	django.contrib.admin.options.delete_view	admin:authapp_shopuser_delete
/control/authapp/shopuser/<path:object_id>/history/	django.contrib.admin.options.history_view	admin:authapp_shopuser_history
/control/authapp/shopuser/add/	django.contrib.admin.options.add_view	admin:authapp_shopuser_add
/control/authapp/shopuser/autocomplete/	django.contrib.admin.options.autocomplete_view	admin:authapp_shopuser_autocomplete
/control/basketapp/basket/	django.contrib.admin.options.changelist_view	admin:basketapp_basket_changelist
/control/basketapp/basket/<path:object_id>/	django.views.generic.base.RedirectView
/control/basketapp/basket/<path:object_id>/change/	django.contrib.admin.options.change_view	admin:basketapp_basket_change
/control/basketapp/basket/<path:object_id>/delete/	django.contrib.admin.options.delete_view	admin:basketapp_basket_delete
/control/basketapp/basket/<path:object_id>/history/	django.contrib.admin.options.history_view	admin:basketapp_basket_history
/control/basketapp/basket/add/	django.contrib.admin.options.add_view	admin:basketapp_basket_add
/control/basketapp/basket/autocomplete/	django.contrib.admin.options.autocomplete_view	admin:basketapp_basket_autocomplete
/control/jsi18n/	django.contrib.admin.sites.i18n_javascript	admin:jsi18n
/control/login/	django.contrib.admin.sites.login	admin:login
/control/logout/	django.contrib.admin.sites.logout	admin:logout
/control/mainapp/product/	django.contrib.admin.options.changelist_view	admin:mainapp_product_changelist
/control/mainapp/product/<path:object_id>/	django.views.generic.base.RedirectView
/control/mainapp/product/<path:object_id>/change/	django.contrib.admin.options.change_view	admin:mainapp_product_change
/control/mainapp/product/<path:object_id>/delete/	django.contrib.admin.options.delete_view	admin:mainapp_product_delete
/control/mainapp/product/<path:object_id>/history/	django.contrib.admin.options.history_view	admin:mainapp_product_history
/control/mainapp/product/add/	django.contrib.admin.options.add_view	admin:mainapp_product_add
/control/mainapp/product/autocomplete/	django.contrib.admin.options.autocomplete_view	admin:mainapp_product_autocomplete
/control/mainapp/productcategory/	django.contrib.admin.options.changelist_view	admin:mainapp_productcategory_changelist
/control/mainapp/productcategory/<path:object_id>/	django.views.generic.base.RedirectView
/control/mainapp/productcategory/<path:object_id>/change/	django.contrib.admin.options.change_view	admin:mainapp_productcategory_change
/control/mainapp/productcategory/<path:object_id>/delete/	django.contrib.admin.options.delete_view	admin:mainapp_productcategory_delete
/control/mainapp/productcategory/<path:object_id>/history/	django.contrib.admin.options.history_view	admin:mainapp_productcategory_history
/control/mainapp/productcategory/add/	django.contrib.admin.options.add_view	admin:mainapp_productcategory_add
/control/mainapp/productcategory/autocomplete/	django.contrib.admin.options.autocomplete_view	admin:mainapp_productcategory_autocomplete
/control/password_change/	django.contrib.admin.sites.password_change	admin:password_change
/control/password_change/done/	django.contrib.admin.sites.password_change_done	admin:password_change_done
/control/r/<int:content_type_id>/<path:object_id>/	django.contrib.contenttypes.views.shortcut	admin:view_on_site
/control/social_django/association/	django.contrib.admin.options.changelist_view	admin:social_django_association_changelist
/control/social_django/association/<path:object_id>/	django.views.generic.base.RedirectView
/control/social_django/association/<path:object_id>/change/	django.contrib.admin.options.change_view	admin:social_django_association_change
/control/social_django/association/<path:object_id>/delete/	django.contrib.admin.options.delete_view	admin:social_django_association_delete
/control/social_django/association/<path:object_id>/history/	django.contrib.admin.options.history_view	admin:social_django_association_history
/control/social_django/association/add/	django.contrib.admin.options.add_view	admin:social_django_association_add
/control/social_django/association/autocomplete/	django.contrib.admin.options.autocomplete_view	admin:social_django_association_autocomplete
/control/social_django/nonce/	django.contrib.admin.options.changelist_view	admin:social_django_nonce_changelist
/control/social_django/nonce/<path:object_id>/	django.views.generic.base.RedirectView
/control/social_django/nonce/<path:object_id>/change/	django.contrib.admin.options.change_view	admin:social_django_nonce_change
/control/social_django/nonce/<path:object_id>/delete/	django.contrib.admin.options.delete_view	admin:social_django_nonce_delete
/control/social_django/nonce/<path:object_id>/history/	django.contrib.admin.options.history_view	admin:social_django_nonce_history
/control/social_django/nonce/add/	django.contrib.admin.options.add_view	admin:social_django_nonce_add
/control/social_django/nonce/autocomplete/	django.contrib.admin.options.autocomplete_view	admin:social_django_nonce_autocomplete
/control/social_django/usersocialauth/	django.contrib.admin.options.changelist_view	admin:social_django_usersocialauth_changelist
/control/social_django/usersocialauth/<path:object_id>/	django.views.generic.base.RedirectView
/control/social_django/usersocialauth/<path:object_id>/change/	django.contrib.admin.options.change_view	admin:social_django_usersocialauth_change
/control/social_django/usersocialauth/<path:object_id>/delete/	django.contrib.admin.options.delete_view	admin:social_django_usersocialauth_delete
/control/social_django/usersocialauth/<path:object_id>/history/	django.contrib.admin.options.history_view	admin:social_django_usersocialauth_history
/control/social_django/usersocialauth/add/	django.contrib.admin.options.add_view	admin:social_django_usersocialauth_add
/control/social_django/usersocialauth/autocomplete/	django.contrib.admin.options.autocomplete_view	admin:social_django_usersocialauth_autocomplete
/disconnect/<backend>/	social_django.views.disconnect	cosial:disconnect
/disconnect/<backend>/<association_id>/	social_django.views.disconnect	cosial:disconnect_individual
/login/<backend>/	social_django.views.auth	cosial:begin
/media/<path>	django.views.static.serve
/new/	mainapp.views.main	main_new
/order/	ordersapp.views.OrderListView	ordersapp:orders_list
/order/create/	ordersapp.views.OrderCreateView	ordersapp:order_create
/order/delete/<int:pk>/	ordersapp.views.OrderDeleteView	ordersapp:order_delete
/order/forming/complite/<int:pk>/	ordersapp.views.order_forming_complete	ordersapp:order_forming_complete
/order/product/<int:pk>/price/	ordersapp.views.get_product_price	ordersapp:order_delete
/order/read/<int:pk>/	ordersapp.views.OrderDetailView	ordersapp:order_read
/order/update/<int:pk>/	ordersapp.views.OrderUpdateView	ordersapp:order_update
/popular/	mainapp.views.main	main_popular
/products/	mainapp.views.products	products:index
/products/<int:pk>/	mainapp.views.products	products:category
/products/product/<int:pk>/	mainapp.views.product	products:product
